-12
14
-10
11
111111111111111111111111111
111111111111111111111111111
111111111111111111111111111
111111111111111111111111111
111111111111111111111111111
111111111111111111111111111
111111111111111111111111111
111111111111111111111111111
111100000111000001111111111
111100000000000000000111111
111100000000000000000111111
100000000000000000000111111
111100000000000000000111111
111100000000000000000111111
111100000000000000000111111
111100000000000000000111111
111100000000000000000111111
111100001111111111111111111
111111111111111111111111111
111111111111111111111111111
111111111111111111111111111
111111111111111111111111111
